pivot d키를 눌러서 설정, 해제 // 초기화 : modify->center pivot
hold x : grid snap
hold c : curve snap
hold v : point snap

d + v =>pivot을 포인트 스냅으로 조짐
edit -> duplicate special -> 뭔가 여러 설정해서 한번에 복사
	instance : 종속되어가지구 원본꺼랑 같이 바뀜. copy: 독립된 개체
복사 : ctrl d // shift lmb

Polygon mesh data 정리: Delete history(alt shift d) + Modify -> Freeze Transformation => 이거 안해주면 마야 렉걸리니간 자주자주

hide obj : ctrl h
hide unslected ob : alt h
unhide previous hidden obj: ctrl shift h

p -> 하위로 만들어
shifp p : unparent
ctrl g : group

face 선택 후 ctrl rmb ->to shell
shift rmb -> combine : 하나의 객체로 만들어
extract는 combine된 하나의 객체에서만 가능
독립된 객체를 extract할 수 없다
extract : shift x

modify -> align tool//align object
	-> snap together tool/ snap to polygon face 선택하면 원하는 위치에 정렬 가능.

face/edge 선택 -> shift rmb -> bevel  # bevel 할 때에는 잘 생각해서 한번에 선택해서 할 것.
shift rmb -> merge vertex/edge 합치는거 
distance treshold => 거리 내에 있는거 merge
shfit rmb -> merge -> target weld tool => merge 할거 선택할 수 이슴
shift rmb -> connect component => 요소 연결
face -> space -> mesh display -> <normal> average 평균값으로 노말 설정

face 선택 -> shift rmb-> extrude
	keep face together -> face들 방향 평균인지 아닌지
	extrude 한 순간 하나 더 생기는거.

결합할 떄 face 지워야 잘 댐.

shift mirror -> 미러링으루다가 복사
ctrl shift symmetry -> 방향 설정 후 작업하면 대칭으로 계속 됨

uv 맵 -> seam제봉선 같은거 잘안보이는데에만들어야댐

intialshadinggroup  의 램버트는 건들지 마.
rmb -> assgin new material =>  새로운 메테리얼 생성. lambert2에 속성 나와
uv coordinate 로 속성 조정

 face 선택 후 rmb assgin new material 하면 face별로 생성 가능

boolean
union		difference		subtract
그냥합쳐		차집합			공집합

두개 선턱 후   shirt rmb boolean ->union/difference/intersection(substract)
boolean은 멍청하게 사용하지 말자.  엣지랑 버텍스 수 좀 고려해야해/ 버텍스랑 엣지 겹쳐서 하지 않기.	

arnold - > lights -> physical sky  정도 사용하기

ipr로 하면 실시간으로 렌더된거 볼 수 이슴
